^^^^^^^^^^^^^^^^^^^^^^^^^^^^^^^^^^^^^^^^^^^^^^^^^^^^^^^^^^^^
^^^^^^^^^^^^^^^^^^^^^^^^^^^^^^^^^^^^^^^^^^^^^^^^^^^^^^^^^^^^
^^^^^^^^^^^^^^^^^^^^^^^^^^^^^^^^^^^^^^^^^^^^^^^^^^^^^^^^^^^^
^^^^^^^^^^^^^^^^^^^^##:::::::::::::::##^^^^^^^^^^^^^^^^^^^^^
^^^^^^^^^^^^^^^^^^^^###################^^^^^^^^^^^^^^^^^^^^^
^^^^^^^^^^^^^^^^^^^^:#...:::...:::...#:^^^^^^^^^^^^^^^^^^^^^
^^^^^^^^^^^^^^^^^^^^:#.S.:::.*.:::.S.#:^^^^^^^^^^^^^^^^^^^^^
^^^^^^^^^^^^^^^^^^^^:#...:::::::::...#:^^^^^^^^^^^^^^^^^^^^^
^^^^^^^^^^^^^^^^^^^^:#:::::::::::::::#:^^^^^^^^^^^^^^^^^^^^^
^^^^^^^^^^^^^^^^^^^^:#:::::::::::::::#:^^^^^^^^^^^^^^^^^^^^^
^^^^^^^^^^^^^^^^^^^^:##::#########::##:^^^^^^^^^^^^^^^^^^^^^
^^^^^^^^^^^^^^^^^^^^:#..........D#...#:^^^^^^^^^^^^^^^^^^^^^
^^^^^^^^^^^^^^^^^^^^:#D..............#:^^^^^^^^^^^^^^^^^^^^^
^^^^^^^^^^^^^^^^^^^^:#...............#:^^^^^^^^^^^^^^^^^^^^^
^^^^^^^^^^^^^^^^^^^^:#...#.......#...#:^^^^^^^^^^^^^^^^^^^^^
^^^^^^^^^^^^^^^^^^^^#########.#########^^^^^^^^^^^^^^^^^^^^^
^^^^^^^^^^^^^^^^^^^^##::::###.###::::##^^^^^^^^^^^^^^^^^^^^^
^^^^^^^^^^^^^^^^^^^^^^^^^^:::.:::^^^^^^^^^^^^^^^^^^^^^^^^^^^
^^^^^^^^^^^^^^^^^^^^^^^^^^:::.:::^^^^^^^^^^^^^^^^^^^^^^^^^^^
^^^^^^^^^^^^^^^^^^^^^^^^^^###P###^^^^^^^^^^^^^^^^^^^^^^^^^^^